1111111111111111111111111111111111111111111111111111111111111111
1                                                              1
1                                                              1
1    11111111111111111111111111111111111111111111111111111111111
1                11 11111 1 1 11 11 1111111111111              1
1     111 1 11 1                                               1
1                                                              1
1                                                              1
1                                                              1
1                                P                             1
1                                                              1
1                                                              1
1                                                              1
1                                                              1
1                                       111                    1
1                    1                 11 11                   1
1                    11                1   1                   1
1                    1111             1    1                   1
1                    1  11            1  G 1                   1
1                    1    1          1  GG 1                   1
1                    1 G   11       1    G 1                   1
1                    1 GG   1 11111111     1                   1
1                    1 G   1111      111    1                  1
1                    1   111                1                  1
1                    1                  1   1                  1
1                    1 11               11  1                  1
1                    1 1                 1  1                  1
1                     1                  11 1                  1
1                     1                   11                   1
1                    1                    1                    1
1                    1    DDD      DDD    1                    1
1                    1     DP       D0    11             1111  1
1                    1 11                  1   11 1111111      1
1        111111 11111111                  1111                 1
1    1111           11                 111 1                   1
1                   1          MMM         1                   1
1                   11 11       M          1                   1
1                11 1111        11     1111111 1 1 11111       1
1        111 111     1    1    1111 1      1                   1
1    11111           1    11  11  111     11                   1
1                    1      111          11                    1
1                    11                  1                     1
1                     11                11                     1
1                      11             1111111                  1
1                       11          111     1111               1
1                       11111     111          111             1
1                     11     11P111              11            1
1                   11                            11           1
1                  11      0  0        0            1          1
1                  1                                11         1
1                 11                                 1         1
1                 1          N                                 1
1                 1                                            1
1                 1                                            1
1                                                              1
1                                                              1
1                                                              1
1                                                              1
1                                                              1
1                                                              1
1                                                              1
1                                                              1
1                                                              1
1111111111111111111111111111111111111111111111111111111111111111
