11111111111111111111111111111
10000000001100000000000000001
10110000011100000001111011111
11111111110000000000000000011111
        10110000011100000000000111111
        1000000000110000011111111111
11111111111111011100000010001
11110111111111011101010010001
11000000G00101011100000010001
11111111000000001100000010001
       10000000000000001100011111111
    11110000110101000000000011111
        1111111111111111111011111
        1111111111111111111011111
        1111111111111111111011111
        1111111111111111111011111
        1111111111111111111011111
        1111111111111111111011111
        1000000000110000M00P00001
        1011000001110000000000001
        1001000000000000000000001
111111111011000001110000000000001
1G0000000011000001111111111111111
111101111111110111
1111P1111111111111
1100000M11010G0111
1G0000000D0000011
10000000G100000011
110000011101G10111
1111D111 1110101
11110111 1111111
111101111111111
111101111111111
111101111111111
111101111111111
1000P000M000001
100000000000001
10G0000000G0001
100000000000001
10000G000000001
10000000N000001
10G0000000G0001
100000000000001
111111111111111
