1111111111111111111111111111111111111111111111111111111111111111
1000000000000000000000000000000000000000000000000000000000000001
1000000000000000000000000000000000000000000000000000000000000001
1111100100000000000000000000000000000000000000000000000010000001
1000100100000000000000100000000000000000000000000000000010000001
1000100100000001000000100000000011111111111111000100000010000001
1000100100000000000000100000000000000000000000000100000010000001
1000100100000000000000100000000000000000000000000111100010000001
1000100100000111111111100000000000000000000000000100000010000001
1000100100000000000000100000000000000000000000000100000010000001
1000100100000000000000100000000000000001000000000100000010010001
1000100100000000000000100000000000000000000000000100000010000001
1000100100000000000000100000010000000000000000000100000010000001
1000100100000000000000100000000000000000000000000100000010000001
1000100100000000000001100000000000000000000000000100000010000001
1000100100000100000001000000000000000000000000000100000010000001
1000100100000000000001000000000001000000000000000100000010000001
1000100100000000000001000000000001000000000000000100010010000001
1000100100000000000000000000000001000000000000000100000010000001
1000100100000000000000000000000001000000000000000100000010000001
1000100100000000000000000000000001000000000000000100000010000001
1000100100000000000000000000000011000000000000000100000010000001
1000100100000000000000000100000010000000000000000100000010000001
1000100100000000000000000100000010000000000000000100000010000001
1000100101111111111110000100000010000000000000000100000010000001
1000100101000000000010000100000010000000000100000100000010000001
1000100101000000000010000100000010000000000000000100000010000001
1000100101000000000010000100000010000000000000000100000010000001
1000100101111111000010000100000010000000000000001111100110000001
1000100100000001000010000100000110000000000000000000000100000001
1000100100111001000010000100000100000000000000000000000100000001
1000100100101001000010000110000100000000000000000000000100000001
1000100000101001000010000011000100000000000000000000000100000001
1000100000101001000010000001000100000000000000000000000000000001
1111111111101001000010000001000110000000000111111100000000000001
1000000000001001000010000001110010000000000000000110000000000001
1000000000001001000010000000010010000000000000000010000000000001
1000000010001001000000000000010010000000000000000010000000000001
1000000010001000000011111111111111111110000000000010000000000001
1000000010001000000000000000000000000010000000000010000000000001
1000000010011111111000000000000000000010000000000010000000000101
1000000010000000000000000000000000000100000000000010000000000001
1000000010000000000000000000000000000100000000000010000001000001
1000000010000000000000000000111111000100000000000010000000000001
1000000010000000000000000000000000000100001000000010000000000001
1000000010000000000000000000000000000100000000000010000000000001
1000000010000000000000000000000000000100000000000010000000000001
1000000010000000100000001000000000000100000000000010000000000001
1000000000000000000000001000000000000000000000000010000000000001
1000000000000000000000001000000000000000000000001111111111111101
1000000000000000000000001000000000000000000000000000000000000001
1000000000000000000000001000000000000000000000000000000000000001
1000000000010000000000001000000010000000000000000000000000000001
1000000000000000000000001000000000000000000000000001000000000001
1000000000000000000000001000000000000000000010000000000000000001
1000000000000000000000001000000000000000000000000000000000000001
1000011111111111111111111111111111111110000000000010000000010001
10000M000G000G000G0000000000000000000000000000000000000000000001
1000000000000000000000000000000000000000000000000000000000000001
1000000000000000000000000000000000000000000000100000100000000001
1000N00000000000001000000000000000000000000000000000000000000001
1000000000000000000000000000000000000000000000000000000000000001
1000000000000000000000000000000000000000000000000000000000000001
1111111111111111111111111111111111111111111111111111111111111111
