111111111111111111111111111111111111111111111111111111111111111111
110001000000000100010000000001100000000000000000000000000000000001
1100010000000001000D0000000001100000000000000000000000000000000001
111111000000000100010000000001100000000000000000000000000000000001
110001000000000111110000000001100000000000000000000000000000000001
11000D000000000111110000000001100000000000000000000000000000000001
110001000000000100010000000001100000000000000000000000000000000001
110001000000000D00010000000001100000011111111100000000000000000001
11000100000000010001000000000110000001000G000100000000000000000001
1100011111D1111111111111111111111111110000000111111111111111111111
110000000000000000000000000000100001110000000111000000000000000011
110000000000000000000000000000D0000111111D111111000000000000000011
110000000000000000000000000000100000000000000000000000000000000011
111111111111111100011111111D111100000000000000000001111D1111000011
100000000000000100010001000000010000000000000000000100000001000011
100000000000000100010001000000011111111111111111111100000001000011
100000000000000100010001000000000000000000000000000000000001000011
10000000000000010001000D000000000000000000000000000000000001000011
100000000000000100010001000000000000000000000000000000000001000011
100000000000000100010001000000011111111110111111111100000001000011
100000000000000100010001000000010000000100010000000100000001000011
100000000000000100010001111111110000000100010000000111111111000011
100000000000000100010000000000010000000000000000000100000000000011
100000000000000100010000000000010000000100010000000100000000000011
100000000000000100010000000000010000000100010000000100000000000011
111111111111111100011111111100000000000000000000000000011111111111
110000000100000000001000000100010000000100010000000100010000000011
11000000010000000000D000000100010000000100010000000100010000000011
110000000100000000001000000100000000000000000000000D00010000000011
11000111111111011111111100010001000000010001000000010000000G000011
110001000100000000010001000100010000000100010000000100010000000011
110001G001000000000D00G1000100000000000000000000000100010000000011
110001000100000000010001000100010000000100010000000100010000000011
110001111111111111111111000100010000000100010000000110111111111111
110000000000000000000000000100000000000000000000000100010000011111
1100000000000000000000000001000100000001000100000001000D00000G1111
110000000000000000000000000100010000000100010000000100010000011111
1100011111D1111100011111111100010000000100010000000100011101111111
11000100000000011D110000000000000000000000000000000100000000000011
110001000000000100010000000000010000000100010000000100000000000011
110001000000000100010000000000010000000100010000000100000000000011
11000100000000110001000111111111111111111D111111111111111111100011
11000D0000G0001100010001000000000000000000000000000000000001100011
11000100000000110001000100000000000000000G000000000000000001100011
110001000000000100010001000000000000000000000000000000000001100011
110001000000000100010001100000011111000011100001111100000011100011
1100010000000001000100011000G0011111000111110001111100G00011100011
1100011111D1111100010001100000011111000011100001111100000011100011
110000000000000100010001000000000000000000000000000000000001100011
110000000000000100010001000000000000000000000000000000000001100011
110000000000000100010001000000000000000000000000000000000001100011
1111D1111111000100010001111111111111111100011111111111111111100011
110000000001101100010000000000000000000100010000000000000001100011
1100000000011001000100000000000000000000000D0000000000000001100011
110000000001100100010000000000000000000100010000000000000001100011
110000000001111100011111111111111111111100011111111111111111100011
110000000001111100010000000000000100000000000000010000000000000011
110000000001111100000000000000000000000000000000000000000000000011
110000000001111100010000000000000100000000000000010000000000000011
110000000001111111111111111111111111111111111111111111111111111111
110000000001000000000000000000000000000000000000000000000000000001
110000000001000000000000000000000000000000000000000000000000000001
110000000001000000000000000000000000000000000000000000000000000001
111110111111111111111111111111111111111111111111111111111111111111
1G000P0M00G1
100000000001
1G00000000G1
100000000001
1G00000000G1
10000N000001
1G00000000G1
111111111111