1111111111111111111111111111111111111111111111111111111111111111
1000000000000000000000000000000000000000000000000000000000000001
1000000000000000000000000000000000000000000000000000000000000001
1000011111111111111111111111111111111111111111111111111111111111
1000000000000000011011111010101101101111111111111000000000000001
1000001110101101000000000000000000000000000000000000000000000001
1000000000000000000000000000000000000000000000000000000000000001
1000000000000000000000000000000000000000000000000000000000000001
1000000000000000000000000000000000000000000000000000000000000001
100000000000000000000000000000000P000000000000000000000000000001
1000000000000000000000000000000000000000000000000000000000000001
1000000000000000000000000000000000000000000000000000000000000001
1000000000000000000000000000000000000000000000000000000000000001
1000000000000000000000000000000000000000000000000000000000000001
1000000000000000000000000000000000000000111000000000000000000001
1000000000000000000001000000000000000001101100000000000000000001
1000000000000000000001100000000000000001000100000000000000000001
1000000000000000000001111000000000000010000100000000000000000001
10000000000000000000010011000000000000100G0100000000000000000001
1000000000000000000001000010000000000100GG0100000000000000000001
10000000000000000000010G00011000000010000G0100000000000000000001
10000000000000000000010GG000101111111100000100000000000000000001
10000000000000000000010G0001111000000111000010000000000000000001
1000000000000000000001000111000000000000000010000000000000000001
1000000000000000000001000000000000000000100010000000000000000001
1000000000000000000001011000000000000000110010000000000000000001
1000000000000000000001010000000000000000010010000000000000000001
1000000000000000000000100000000000000000011010000000000000000001
1000000000000000000000100000000000000000001100000000000000000001
1000000000000000000001000000000000000000001000000000000000000001
10000000000000000000010000DDD000000DDD00001000000000000000000001
100000000000000000000100000DP0000000D000001100000000000001111001
1000000000000000000001011000000000000000000100011011111110000001
1000000001111110111111110000000000000000001111000000000000000001
1000011110000000000011000000000000000001110100000000000000000001
1000000000000000000010000000000MMM000000000100000000000000000001
10000000000000000000110110000000M0000000000100000000000000000001
1000000000000000011011110000000011000001111111010101111100000001
1000000001110111000001000010000111101000000100000000000000000001
1000011111000000000001000011001100111000001100000000000000000001
1000000000000000000001000000111000000000011000000000000000000001
1000000000000000000001100000000000000000010000000000000000000001
1000000000000000000000110000000000000000110000000000000000000001
1000000000000000000000011000000000000011111110000000000000000001
1000000000000000000000001100000000001110000011110000000000000001
1000000000000000000000001111100000111000000000011100000000000001
1000000000000000000000110000011D11100000000000000110000000000001
1000000000000000000011000000000000000000000000000011000000000001
1000000000000000000110000000000000000000000000000000100000000001
1000000000000000000100000000000000000000000000000000110000000001
1000000000000000001100000000000000000000000000000000010000000001
10000000000000000010000000000N0000000000000000000000000000000001
1000000000000000001000000000000000000000000000000000000000000001
1000000000000000001000000000000000000000000000000000000000000001
1000000000000000000000000000000000000000000000000000000000000001
1000000000000000000000000000000000000000000000000000000000000001
1000000000000000000000000000000000000000000000000000000000000001
1000000000000000000000000000000000000000000000000000000000000001
1000000000000000000000000000000000000000000000000000000000000001
1000000000000000000000000000000000000000000000000000000000000001
1000000000000000000000000000000000000000000000000000000000000001
1000000000000000000000000000000000000000000000000000000000000001
1000000000000000000000000000000000000000000000000000000000000001
1111111111111111111111111111111111111111111111111111111111111111
