1111111111111111111111111111111111111111111111111111111111111111111111111111111111111111111111111111111111111111111111
1000000000000001000000000000000000000000001000000000000000000000000000100000000000000000000000000010000000000000000001
1000000000000001000000000000000000000000001000000000000000000000000000100000000000000000000000000010000000000000000001
1N00000000000001000000000000000000000000001000000000000000000000000000100000000000000000000000000010000000000000000001
1000000000000001000000000000000000000000001000000000000000000000000000100000000000000000000000000010000000000000000001
1000000000000001000000000000000000000000001000000000000000000000000000100000000000000000000000000010000000000000000001
1000000000000001000000000000000000000000001000000000000000000000000000100000000000000000000000000010000000000000000001
1000000000000001000000000000000000000000001000000000000000000000000000100000000000000000000000000010000000000000000001
1000000000000001000000000000000000000000001000000000000000000000000000100000000000000000000000000010000000000000000001
1111111111111111111111111111111111111111111111111111111111111111111111111111111111111111111111111111111111111111111111
