111111111111111111111111111111111111111111111111111111111111111111
1011000000000D00111000001000000000000000D00G00100G00100G00100G0011
101000000000010000100000100000000000010010000010000010000010000011
1010001111111100G01000001000G1000000010010000010000010000010000011
111D11111111111111110001111111111111111110000010000010000010000011
110000000000010000000000000001000000000110000010000010000010000011
1100000000000D000000000000000D0000000001111D11111D11111D11111D1111
110000000000010000000000000001000000000010000000000000000000000011
110000111111111111111D11111111111111000010000000000000000000000011
1110011000001100000100010000011000010000D0000000000000000000000011
11100110000001G0000D000D0000G1000001000010000000000000000000000011
111001100000010000010001000001000001000010000000000000000000000011
110000111111D111111111111111111D11110001111D11111D11111D11111D1111
110000001110001110001110000000000000000110000010000010000010000011
110000000000000000000000000000000000000110000010000010000010000011
110000000000000000000000000000000000000110000010000010000010000011
110000001110001110000000000000000011100110000010000010000010000011
1111111111111111111100011111100011111111100G00100G00100G00100G0011
100000000000000001111D11111111D11111111111111111111111111111111111
10000000000000GG01000000000000000000000011111111111111111111111111
10000000000000GG01000000000000000000000010000000000000000000000011
100000000000000001000000000000000000000010000000000000000000000011
100011111111111111111111111111111111100010000000000000000000000011
100010000000111111111000000011000001100010001111111111111111100011
100010000000100000001000000010000000100010001000000010000000100011
100010000000100000001000000010000000100010001000000010000000100011
100010000000D000G000D0000000D000G000100010001000G0001000G000100011
100010000000100000001000000010000000100010001000000010000000100011
100010000000100000001000000010000000100010001000000010000000100011
10001000000011111111100000001100000110001000111111D111D11111100011
10001111D111111111111111111111111111100010000000000000000000000011
100011000001100000000000000001111111100010000000000000000000000011
100010000000100000000000000001000000100010000000000000000000000011
10001000000010000000000000000100000010001111111111111111111111D111
10001000G000100000000000000001000000D00010000000000000000000100011
100010000000100000000000000001000000100010000000000000000000100011
100010000000100000000000000001000000100010000000000000000000100011
100011000001100000000000000001000000100010001111100011111000100011
10001111D11111111111111111111111D111100010001000000010001000100011
100011000000100000001000000010000000100010001000000010G01000100011
100010000000100000001000000010000000100010001000000010001000100011
100011000000100000001000000010000000100011D11111100011D11000100011
100010000000D00000011000000010000000D00010001111100000000000100011
100011000000100000001000000010000000100010001111000000000000100011
100010000000100000001000000010000000100010001111100000000000100011
100011010101100000001000000010000000100010000001111111111111100011
1000111111111111D1111111111111111111100010001000000000000000100011
100010000000110000001000001110000000100010001000000000000000100011
100010000000100000001000001110000000100010001000000000000000100011
100010000000100000001000000010000000100011D11111111111111000100011
100010000000D0000000D0000000D0000000D00010000000000000001000100011
100010000000100000001000000010000000100010000000000000001000100011
100011000000100000001110001110000000100010000000000000001000100011
1000101000001000000100100010100000001000111111D1111110001000100011
10001001D111111111111111111111111111100010000000000010001000100011
100011110111100000000000000010000000100010000000000010001000100011
100010000000100000000000000010000000100010010000010010001000100011
100010000000100000000000000010000000100010000000000010001000100011
10001111111D100000000000000010000000D000D00000G00000D0001000100011
100010110000100000000000000010000000100010000000000010001111100011
1000D011000010000000000000001000000011D110010000010010001000000011
10011D11D11110000000000000001000000010G01000000000001000D000000011
100100000000100000000000000011111111110110000000000010001000000011
111111111111111111111111111111111111111111111111111111111101111111
1111111111111111111111111111111111111111111111111111111111P1111111
100000000000000000111111111111111111111111110000000000110000001111
100000000000000000110000000000000000000000110000000001100000000111
111111111111111111100000000000000000000000010000000001000000000011
110001000100000000100000000000000000000000010000000001000011000011
1100010001000000001000011D1111000111111100010000000001000111100011
11G00D000100000000100001100001000100000100010000000001000111100011
1100010001000000001000011000010001000001000100000000010000G0000011
11000100010000000010000111G0010001G0000D00010000000001000000000011
111111000100000000100001110001000100000100010000000001000000000011
110001000100000000100001111111000100000100010000000001000000000011
110001000100000000100001111111000111111100010000000001000000000011
11G00D000100000000100000000000000000000000010000000001000000000011
110001000100000000100000000000000000000000010000000001000000000011
110001000110000000110000000000000000000000110000000001000000000011
1111110000111111111111D1111D110001111111111111111111111D1111D11111
110001000000010000001000000001000100000001000000000000000100000111
1100010000000D0000001000000001000100000001000000000000000100000111
11G00D00000001000000100100100100010000000D000000000000000111011111
110001000011D11110001000000001000100000001000000000000000100G00011
1100010001010000100010000G0001000100000001000000000000000100000011
1111110001010G0010001000000001000100000001111111111111111111111111
110001000111111110001001001001000100000001000000000000000000000011
11000100010000001000100000000D00010000000D000000000000000000000011
11G00D000100000G10001000000001000100000001000000000000000000000011
1100010001000000100011111111110001111111111111111D111111D11D111111
110001000D00111111D11111111100000000000001000111000111100000010011
11111111111111111000100000010000000000000D000000000111000000001011
111111111111100000001000000100000000000001000000000110000000000111
110000000000100000001000000100000000000001000000000100000000000011
11000000000010000000100000010000000000000100101110010000G11G000011
110000000000100011D11000000111000000000001001010000100001111000011
11000000000010001000100000000100000000000D0011G1100100001111000011
1100000000001000100010000000011D11000000010000D0100100001111000011
11000000000010001000100000000100010000000100111010010000G11G000011
1100000011D1100010001000000001000100000001000000000100000000000011
110000001000000010001000000001000100000001000000000110000000000111
110000001000000011D1100000000100010000000D000000000111000000001001
111D11111000000010001000000001000100000001000111000100D00000010001
110000000000111110001111100001000100000001111111111100111111111001
110000000000100000000000100001000100000000001000000100000000001001
110000000000100000000000100001000100000000001000000100000000001001
111111111111100110001100100001000100000000001000000100000000001001
10100000001110011000110011111100011111D110001000000100000000001001
101000000010000000000000001000000000100010001000000100000000001001
1010000000D0000000G0000000D000000000D0001000100000010000G000001001
101000000010000000000000001000000000100010001000000100000000001001
101000000011100110001100111111000111100011D11000000100000000001001
101000111111100110001100100001000100000010001000000100000000001001
1010001010101000000000001G000D000100000010001000000100000000001001
1010001010G0100000000000100001000100000010001000000111111111111001
101000101D11111110001111111111000100000010001000000000010000000001
1010001010000000100010000G0011000100000010001000000000010000000001
101000101000000011D11000000011000100000010001000000000010000000001
101000101000000010001000000011000100000010001000000000010000000001
101000101000000010001000000011000100000010001000000000010000000001
1011D1111111D11110001111D11111000111111110001000000000010000000001
1010001000100000000000000010011D1100111110001111111111110000000001
101000100010000000000000001000000000100000000000010000010000000001
101000100010001G10001G10001000000000100000000000010000010000000001
1010001000100011100011100010000000001000000000000D0000010000000001
101000100010000000000000001000000000100000000000010000010000000001
101000100110000000000000001000000000100000000000010000010000000001
111101111111111111111111111111111111111111111111111111111111111111
1111P1111111111111111111111111111111111111111111111111111111111111
110001000000000100010000000001100000000000000000000000000000000001
1100010000000001000D0000000001100000000000000000000000000000000001
11D111000000000100010000000001100000000000000000000000000000000001
110001000000000111110000000001100000000000000000000000000000000001
11000D000000000111110000000001100000000000000000000000000000000001
110001000000000100010000000001100000000000000000000000000000000001
110001000000000D00010000000001100000011111111100000000000000000001
11000100000000010001000000000110000001000G000100000000000000000001
1100011111D1111111111111D11111111111110000000111111111111111111111
110000000000000000000000000000100001110000000111000000000000000011
110000000000000000000000000000D0000111111D111111000000000000000011
110000000000000000000000000000100000000000000000000000000000000011
111111111111111100011111111D111100000000000000000001111D1111000011
100000000000000100010001000000010000000000000000000100000001000011
100000000000000100010001000000011111111111111111111100000001000011
100000000000000100010001000000000000000000000000000000000001000011
10000000000000010001000D00000000000000000000000000000000000D000011
100000000000000100010001000000000000000000000000000000000001000011
100000000000000100010001000000011111111110111111111100000001000011
100000000000000100010001000000010000000100010000000100000001000011
100000000000000100010001111D111100000001000100000001111D1111000011
100000000000000100010000000000010000000000000000000100000000000011
100000000000000100010000000000010000000100010000000100000000000011
100000000000000100010000000000010000000100010000000100000000000011
111111111111111100011111111100000000000000000000000D00011111111111
110000000100000000001000000100010000000100010000000100010000000011
110000000D0000000000D000000100010000000100010000000100010000000011
110000000100000000001000000100000000000000000000000D00010000000011
1100011111111101111111110001000100000001000100000001000D000G000011
110001000100000000010001000100010000000100010000000100010000000011
110001G00D000000000D00G1000100000000000000000000000D00010000000011
110001000100000000010001000100010000000100010000000100010000000011
11000111111111111111111100010001000000010001000000011D111111111111
110000000000000000000000000100000000000000000000000100010000011111
1100000000000000000000000001000100000001000100000001000D00000G1111
110000000000000000000000000100010000000100010000000100010000011111
1100011111D1111100011111111100010000000100010000000100011101111111
11000100000000011D110000000000000000000000000000000100000000000011
110001000000000100010000000000010000000100010000000100000000000011
110001000000000100010000000000010000000100010000000100000000000011
11000100000000110001000111111111111111111D111111111111111111100011
11000D0000G0001100010001000000000000000000000000000000000001100011
11000100000000110001000100000000000000000G000000000000000001100011
110001000000000100010001000000000000000000000000000000000001100011
110001000000000100010001100000011111000011100001111100000011100011
1100010000000001000100011000G0011111000111110001111100G00011100011
1100011111D1111100010001100000011111000011100001111100000011100011
110000000000000100010001000000000000000000000000000000000001100011
110000000000000100010001000000000000000000000000000000000001100011
110000000000000100010001000000000000000000000000000000000001100011
1111D111D111000100010001111111111111111100011111111111111111100011
1100000000011D1100010000000000000000000100010000000000000001100011
110000000001100100010000000000000000000D000D0000000000000001100011
110000000001100100010000000000000000000100010000000000000001100011
110000000001111100011111111111111111111100011111111111111111100011
110000000001111100010000000000000100000000000000010000000000000011
1100000000011111000D0000000000000D000000000000000D0000000000000011
110000000001111100010000000000000100000000000000010000000000000011
110000000001111111111111111111111111111111111111111111111111111111
110000000001000000000000000000000000000000000000000000000000000001
110000000001000000000000000000000000000000000000000000000000000001
110000000001000000000000000000000000000000000000000000000000000001
111111011111111111111111111111111111111111111111111111111111111111
111111P11111111111111111111111111111111111111111111111111111111111
110011011001000001000000000010000000001100000000000110001000000001
110011011001000001000000000010000000001100000000000110001000000001
110000000001000001110000001110000000001000000000000110001000000001
110000000001000001110000001110000000001000000000000110001000000001
110000100001000001000000000010000000001100000000000110001000000001
11000111000D000001000000000010000000001100000000000110001000000001
11000010000100000100000000001000000000111D111D111D1110001000000001
110000000001000001000000000010000000001000000000000010001000000001
11000000000100000100000000001000000000D0000000000000D0001000000001
110110001101000001000000000010000000011000000000000010001000000001
110111011101000001000000000010001111111111110000111110001111111111
110000000001000001000000000010001111111100010000100010001000000011
111111111D1111D11111D1111D1111D1110000010001000110001000D000000011
111111100011000001000000000000001100000100010001000010001000000011
11000010001100000100000000000000111111D1000100010000100010000G0011
110000D0011100000D000000000000001000000100010001000010001000000011
11000010011100000100000000000000D00000010001000111001000D000000011
110000100111000001000000000000001000000100010001110010001000000011
110000111111111111111111111111111110000100010001000010001111111111
1100001000000000011100000000011111100001000D0001000010001100000111
110000100000000000000000000001100010000100010001000010001100000111
1100001000000000000000000000011000D0000111110001001111011100100111
110000100011111110001111111001100010000000011D11001000000111111111
11000010001000001000100000100110001000000001000D001000000100000011
110000100110000010001000001101100011111111110001111000000100000011
1100001000000G0010001000G00001100000010010000000001000000111111111
1100001001100000100010000011011000000100D000000000D000000100000111
1100001000100000100010000010011000111100100000    1      1      11
11    1   1111111   1111111  11   1  1111   11    11111111     111
11    11                    111 1 1   1    1111     1          111
11    D                     11111111G D    11111    D          111
11    11                    111   1   1    1111     1          111
11    1   1111111   1111111  11   1  1111   11    11111111     111
11    1   1     1   1     1  11   1111  1         1      1      11
11    1  11     1   1     11 11   1  1  D         D      1     111
11    1  D   G  1   1  G   D 11   1  1  1         1      111111111
11    1  11     1   1     11 11   1  1111111   111111    1       1
11    1   1     1   1     1  11   1111111111   111111    1       1
11    1   1111111   1111111  11   11   111111 111  1111111       1
11    11                    111   11    1      1   1             1
11    D                     111   11    D      D   1             1
11    11                    111   11    1      1   1             1
11    1   1111111   1111111  11   11    11111 111111             1
11    1   1     1   1     1  11   11    1   1    1               1
11    1  11     1   1     11 11   11    1   1    1               1
11    1  D   G  1   1  G   D 1111111    1   1    1               1
11    1  11     1   1     11 11111111D111   111111               1
11    1   1     1   1     1  11   11   11   1    1               1
11    1   1111111   1111111  11 S 1     11D11    1               1
11    11                    111   1     1   1    1               1
11    D                     111   1     1   1    1               1
11    11                    111   1     1   1    1               1
11    1   1111111   1111111  11   1     D   1    1               1
11    1   1     1   1     1  11   1     1   1    1               1
11    1  11     1   1     11 11   1     1   1    1               1
11    1  D   G  1   1  G   D 11   1     1   1    1               1
11    1  11     1   1     11 11   1     1   111111               1
11    1   1     1   1     1  11   1     1   1    1               1
11    1   1111111   1111111  111D11111111   1    1               1
11    1                      11             1 G  1               1
11    1                      11             D  111               1
11    1          111         11     111     111111               1
111111111111111111111111111111111111111111111111111111111111111111
