
11111111
100D0001
10010001
100D0001
10010001
10000N01
11111111
