
01111111
10000001
10000001
1N000001
10000001
10000001
11111111
