
11111111
10011001
1000D001
10101001
10001001
10001N01
11111111
