
11111111
10011001
10001001
1010D001
10001001
10001N01
11111111
