111111111111111
100000000000001
100100000010001
100000000000001
100000000000001
1000000N0010001
100100000000001
100000000000001
111111111111111
