
11111111
10100001
10D00001
10100001
10000001
10000N01
11111111
