111111111111111
1B0000000000001
100000000000001
100G000000H0001
100000000000001
1000000N0000001
100000000000001
100000000000001
111111111111111
