1111111111111111111111111111111111111111111111111111111111111111
1                                                              1
1                                                              1
1                                                              1
1                                                              1
1                                                              1
1           11                                                 1
1            11111111 11 1 1 1 11 1 1 11 1 111 111 1111        1
1            1                                        1        1
1            11                                       1        1
1             1                                       1        1
1             1  MM1MM     MM      MMMM      MMMMMMM  1        1
1             1                                       1        1
1             1           MM       M                   1       1
1             1                             M          1       1
1             1                                        1       1
1             1                                        1       1
1                                                      1       1
1             1                                        1       1
1             1                                        1       1
1                                                              1
1              1                                       1       1
1              1                                       1       1
1              1                                       1       1
1                                                              1
1              1                                       1       1
1              1                                       1       1
1              1                                               1
1              1                                       1       1
1              1                                       1       1
1              1        N                                      1
1              1                                        1      1
1              1                                               1
1              1                                        1      1
1              1                                               1
1              1                                        1      1
1              1                                        1      1
1              1                                               1
1              1                                         1     1
1              1                                               1
1              1                                         1     1
1              1                                         1     1
1              1                                               1
1             11                                         1     1
1             1                                          1     1
1             1                                          1     1
1             1                                          1     1
1            11111 1 1 1 1  1 1 1 1 1 1 11 1 11 1 11111111     1
1                                                        1     1
1                                                              1
1                                                              1
1                                                              1
1                                                              1
1                                                              1
1                                                              1
1                                                              1
1                                                              1
1                                                              1
1                                                              1
1                                                              1
1                                                              1
1                                                              1
1                                                              1
1111111111111111111111111111111111111111111111111111111111111111
