111111111111111
100000000000001
1001D0000010001
1000000000D0001
100000000000001
100D000N0D10001
100100000000001
100000000000001
111111111111111
