111111111111111
10M0P000000M001
100000000000001
100000000G00001
100000000000001
10000000N000001
100000000000001
100000000000001
111111111111111
