1111111111111111111111111111111111111111111111111111111111111111
1                                                              1
1                                                              1
1        1                                                     1
1       11       1                                             1
1       1    1   1                                             1
1        1   1                                                 1
1                                                              1
1       1    1   1                                             1
1                                                              1
1         1                      D D D D  D 11111              1
1            1            1     D   11111111   D1111           1
1       1                11111111111             D 111         1
1                1   111111                        D 11        1
1                  111 1  1 1 DG 1G  G1 PG             1       1
1         11  1111 111 1 111 11 1  1 1  1 1  1 1 1  DD 1       1
1   1   11  11 1 11111   G111111111111111111111111111111       1
1          1   11111 11 1 11 11111111111111   1       11       1
1            111      11  1 1    1     1    1 1 1 1    1       1
1          111  11  1 11111 D   1          1       1G D1       1
1         11111111 1 1 1111 1111  111 1111  1 1  11  111       1
1         11  1  1 1    1111D 1   1 1  1    1  11  1 1D11      1
1       1 11   1 1    1G1 1   MMMMMMMMMMMMMMMMMMMMMMMMM11      1
1       G111 1     1   G1 1MMMM                       D11      1
1        1    11       11 1                           D11      1
1      G 1  1  1 1    11  1                          DD11      1
1        1 1111      11   1                         DD 11      1
1      111       1111  G  1                        D   11      1
1      11 1  1111      G  1                      DD    11      1
1     G    1           GG 1                    DD      11      1
1     G  1 111            1                  DD        111     1
1     G      111 1111     1              DDDD          1 1     1
1      1  11 11111   11   1          D DP              1 1     1
1    1G1 1    1       11 11       DD D                G1 11    1
1  11 G                1 D1D   DD                    G 1  1    1
1     G 1     1      DD1  1 DDD    D   D             G 1  1    1
1     G     11      DDD1DD1D D            D  D     GG  1  1    1
1     G          1     1  1D                    DGD    1  1    1
1     G    1           1  1DD D D               G  DD  1  1    1
1     G  1            P1  1        D  D D  D  D  DDDD  1  1    1
1      G     1        11  1               G G          1  1    1
1      1G 1           1   1         G G G              1  1    1
1    1  1GG      1    11  1    G G G                   1  1    1
1   1     111 G      1 11 1 G G                        1  1    1
1   1111 11 1   G G G1G 1G1                            1  1    1
1        1       1   1  1 11                           1  1    1
1           1        1     1 11                        1  1    1
1      11         1  1 1        1 1 1 11 1 1111111111111  1    1
1     1     1     1 1  1                                  1    1
1    1      1    11 1                                     1    1
1   1       11 1 11 1 1             N                     1    1
1   11 111 1    1   1                                     1    1
1              1    11 11                                11    1
1            11     11111   1                            1     1
1            11 1 111 111111                             1     1
1      1         1  1  111111                           11     1
1              1    1111    1111                      11       1
1      1     11   1 1           1 11 111111111111111111        1
1      1     11 1                                              1
1      1                                                       1
1      1                                                       1
1      1                                                       1
1                                                              1
1111111111111111111111111111111111111111111111111111111111111111
