111111111111111
100000000000001
100000H00000001
100000000000001
100100000H00001
1000000N0000001
100000000000001
100000000000001
111111111111111
