
11111111
10000001
10010001
100D1001
10010001
10000N01
11111111
