111111111111111
10000P000000001
100000000000001
100000P00G00001
100000000000001
100P00000000001
10000000N000001
100000000000001
100000000000001
111111111111111
