111111111111111
1000P0000000001
100000000000001
1000000000G0001
100000000000001
1000000N0000001
100000000000001
100000000000001
111111111111111
