
11111111
10000001
10010001
10001001
10000001
10000N01
11111111
