        1111111111111111111111111
        1000000000110000000000001
        1011000001110000000000001
        1001000000000000000000001
111111111011000001110000000000001
1G0000000011000001110111111111111
11110111111111011100000010001
11110111111111011101010010001
1100P000110101011100000010001
10000000000000P01100000010001
10000000G10000001101010010001
1100000111010101111101111000111
11110111 1110101 101111010001
11110111 1111111 111111111111
111101111111111
111101111111111
111101111111111
111101111111111
100101000000001
1000P0000000001
100000000000001
10000000000G001
100000000000001
1000000N0000001
100000000000001
100000000000001
100000000000001
111111111111111
