111111111111111111111111111
111101111111111111111111111
111101111111111111111111111
111101111111111111111111111
111101111111111111111111111
11110111111111111111111111111
11100000000000000000000000001
10000000001100000000000000001
10110000011100000001111011111
11110111110000000000000000011
1011G000011100000000000111111
10000000001100000111101111111
11111111111111011100000010001
11110111111111011101010010001
11000000G00101011100000000G01
11111111000000001100000010001
10000000000000001100011111111
11110000110101000000000011111
1111011111111111111111111111
111101111111111111
111101111111111111
111101111111111111
111101111111111111
111101111111111111
111101111111111111
1000P000000000000111
10000000001100000001
10110000011100000001
10010000000000000001
1111111110110000011111
1G00000000110000011111
1111011111111101111111
1111011111111101111111
1100000011010001111111
1000000000000001111111
10000000G1000000111111
1100000111010101111111
1111011111110101111111
1111011111111111111111
1111011111111111111111
1111011111111111111111
111101111111111
1000P00000000011
1000000000000001
10000000000000011
10000000000000001
100000000G0000001
10000000000000001
10000000N00000001
10000000000000001
10000000000000001
11111111111111111
