NO ./src/textures/Square.xpm
SO ./src/textures/Square.xpm
WE ./src/textures/Square.xpm
EA ./src/textures/Square.xpm

F 220,100,0
C 225,30,0


111111111111111111
1000001000010000001
1000001000010000001
 111111111111111111
 10001
 1111    11111111111111111111111111
        1011000001110000000000001
        1001000000000000000000001
111111110011000001110000000000001
100000000000000001110111111111111
11110111111111011100000010001
1111011111111101 101010010001
11000000110101011100000000001
10000000000000001100000010001
10000000000000001101010010001
11000001110101011111011110N0111
11110111 1110101 101111010001
11111111 1111111 11111111111
