111111111111111111111111111111111111111111111111111111111111111111
1                 11111111111111111111111111          11      1111
1                 11                      11         11        111
1111111111111111111                        1         1          11
11   1   1        1                        1         1    11    11
11   1   1        1    11D1111   1111111   1         1   1111   11
11G  D   1        1    11    1   1     1   1         1   1111   11
11   1   1        1    11    1   1     1   1         1    G     11
11   1   1        1    111G  1   1G    D   1         1          11
111111   1        1    111   1   1     1   1         1          11
11   1   1        1    1111111   1     1   1         1          11
11   1   1        1    1111111   1111111   1         1          11
11G  D   1        1                        1         1          11
11   1   1        1                        1         1          11
11   1   11       11                      11         1          11
111111    111111111111D1111D11   1111111111111111111111D1111D11111
11   1       1      1        1   1       1               1     111
11   1       D      1        1   1       1               1     111
11G  D       1      1  1  1  1   1       D               111 11111
11   1    11D1111   1        1   1       1               1  G   11
11   1   1 1    1   1    G   1   1       1               1      11
111111   1 1 G  1   1        1   1       1111111111111111111111111
11   1   11111111   1  1  1  1   1       1                      11
11   1   1      1   1        D   1       D                      11
11G  D   1     G1   1        1   1       1                      11
11   1   1      1   1111111111   1111111111111111D111111D11D111111
11   1   D  111111D111111111             1   111   1111      1  11
11111111111111111   1      1             D         111        1 11
1111111111111       1      1             1         11          111
11          1       1      1             1         1            11
11          1       1      1             1  1 111  1    G11G    11
11          1   11D11      111           1  1 1    1    1111    11
11          1   1   1        1           D  11G11  1    1111    11
11          1   1   1        11D11       1    D 1  1    1111    11
11          1   1   1        1   1       1  111 1  1    G11G    11
11      11D11   1   1        1   1       1         1            11
11      1       1   1        1   1       1         11          111
11      1       11D11        1   1       D         111        1  1
111D11111       1   1        1   1       1   111   1  D      1   1
11          11111   11111    1   1       11111111111  111111111  1
11          1           1    1   1          1      1          1  1
11          1           1    1   1          1      1          1  1
1111111111111  11   11  1    1   1          1      1          1  1
1 1       111  11   11  111111   11111D11   1      1          1  1
1 1       1               1         1   1   1      1          1  1
1 1       D       G       D         D   1   1      1    G     1  1
1 1       1               1         1   1   1      1          1  1
1 1       111  11   11  111111   1111   11D11      1          1  1
1 1   1111111  11   11  1    1   1      1   1      1          1  1
1 1   1 1 1 1           1G   D   1      1   1      1          1  1
1 1   1 1 G 1           1    1   1      1   1      111111111111  1
1 1   1 1D1111111   1111111111   1      1   1          1         1
1 1   1 1       1   1    G  11   1      1   1          1         1
1 1   1 1       11D11       11   1      1   1          1         1
1 1   1 1       1   1       11   1      1   1          1         1
1 1   1 1       1   1       11   1      1   1          1         1
1 11D1111111D1111   1111D11111   11111111   1          1         1
1 1   1   1               1  11D11  11111   111111111111         1
1 1   1   1               1         1            1     1         1
1 1   1   1   1G1   1G1   1         1            1     1         1
1 1   1   1   111   111   1         1            D     1         1
1 1   1   1               1         1            1     1         1
1 1   1  11               1         1            1     1         1
1111 1111111111111111111111111111111111111111111111111111111111111
