111111111111111111111111111111111111111111111111111111111111111111
11   1         1   1         11                                  1
11   1         1   D         11                                  1
11D111         1   1         11                                  1
11   1         11111         11                                  1
11   D         11111         11                                  1
11   1         1   1         11                                  1
11   1         D   1         11      111111111                   1
11   1         1   1         11      1   G   1                   1
11   11111D1111111111111D1111111111111       111111111111111111111
11                            1    111       111                11
11                            D    111111D111111                11
11                            1                                 11
1111111111111111   11111111D1111                   1111D1111    11
1              1   1   1       1                   1       1    11
1              1   1   1       111111111111111111111       1    11
1              1   1   1                                   1    11
1              1   1   D                                   D    11
1              1   1   1                                   1    11
1              1   1   1       1111111111 1111111111       1    11
1              1   1   1       1       1   1       1       1    11
1              1   1   1111D1111       1   1       1111D1111    11
1              1   1           1                   1            11
1              1   1           1       1   1       1            11
1              1   1           1       1   1       1            11
1111111111111111   111111111                       D   11111111111
11       1          1      1   1       1   1       1   1        11
11       D          D      1   1       1   1       1   1        11
11       1          1      1                       D   1        11
11   111111111 111111111   1   1       1   1       1   D   G    11
11   1   1         1   1   1   1       1   1       1   1        11
11   1G  D         D  G1   1                       D   1        11
11   1   1         1   1   1   1       1   1       1   1        11
11   1111111111111111111   1   1       1   1       11D111111111111
11                         1                       1   1     11111
11                         1   1       1   1       1   D     G1111
11                         1   1       1   1       1   1     11111
11   11111D11111   111111111   1       1   1       1   111 1111111
11   1         11D11                               1            11
11   1         1   1           1       1   1       1            11
11   1         1   1           1       1   1       1            11
11   1        11   1   111111111111111111D1111111111111111111   11
11   D    G   11   1   1                                   11   11
11   1        11   1   1                 G                 11   11
11   1         1   1   1                                   11   11
11   1         1   1   11      11111    111    11111      111   11
11   1         1   1   11   G  11111   11111   11111  G   111   11
11   11111D11111   1   11      11111    111    11111      111   11
11             1   1   1                                   11   11
11             1   1   1                                   11   11
11             1   1   1                                   11   11
1111D111D111   1   1   11111111111111111   111111111111111111   11
11         11D11   1                   1   1               11   11
11         11  1   1                   D   D               11   11
11         11  1   1                   1   1               11   11
11         11111   111111111111111111111   111111111111111111   11
11         11111   1             1               1              11
11         11111   D             D               D              11
11         11111   1             1               1              11
11         1111111111111111111111111111111111111111111111111111111
11         1                                                     1
11         1                                                     1
11         1                                                     1
11111 111111111111111111111111111111111111111111111111111111111111
