111111P11111111111111111111111111111111111111111111111111111111111
11  11 11  1     1          1         11           11   1        1
11  11 11  1     1          1         11           11   1        1
11         1     111      111         1            11   1        1
11         1     111      111         1            11   1        1
11    1    1     1          1         11           11   1        1
11   111   D     1          1         11           11   1        1
11    1    1     1          1         111D111D111D111   1        1
11         1     1          1         1             1   1        1
11         1     1          1         D             D   1        1
11 11   11 1     1          1        11             1   1        1
11 111 111 1     1          1   111111111111    11111   1111111111
11         1     1          1   11111111   1    1   1   1       11
111111111D1111D11111D1111D1111D111     1   1   11   1   D       11
1111111   11     1              11     1   1   1    1   1       11
11    1   11     1              111111D1   1   1    1   1    G  11
11    D  111     D              1      1   1   1    1   1       11
11    1  111     1              D      1   1   111  1   D       11
11    1  111     1              1      1   1   111  1   1       11
11    11111111111111111111111111111    1   1   1    1   1111111111
11    1          111         111111    1   D   1    1   11     111
11    1                      11   1    1   1   1    1   11     111
11    1                      11   D    11111   1  1111 111  1  111
11    1   1111111   1111111  11   1        11D11  1      111111111
11    1   1     1   1     1  11   1        1   D  1      1      11
11    1  11     1   1     11 11   1111111111   1111      1      11
11    1      G  1   1   G    11      1  1         1      111111111
11    1  11     1   1     11 11      1  D         D      1     111
11    1   1     1   1     1  11   1111  1         1      1      11
11    1   1111111   1111111  11   1  1111   11    11111111     111
11    11                    111 1 1   1    1111     1          111
11    D                     11111111G D    11111    D          111
11    11                    111   1   1    1111     1          111
11    1   1111111   1111111  11   1  1111   11    11111111     111
11    1   1     1   1     1  11   1111  1         1      1      11
11    1  11     1   1     11 11   1  1  D         D      1     111
11    1  D   G  1   1  G   D 11   1  1  1         1      111111111
11    1  11     1   1     11 11   1  1111111   111111    1       1
11    1   1     1   1     1  11   1111111111   111111    1       1
11    1   1111111   1111111  11   11   111111 111  1111111       1
11    11                    111   11    1      1   1             1
11    D                     111   11    D      D   1             1
11    11                    111   11    1      1   1             1
11    1   1111111   1111111  11   11    11111 111111             1
11    1   1     1   1     1  11   11    1   1    1               1
11    1  11     1   1     11 11   11    1   1    1               1
11    1  D   G  1   1  G   D 1111111    1   1    1               1
11    1  11     1   1     11 11111111D111   111111               1
11    1   1     1   1     1  11   11   11   1    1               1
11    1   1111111   1111111  11 S 1     11D11    1               1
11    11                    111   1     1   1    1               1
11    D                     111   1     1   1    1               1
11    11                    111   1     1   1    1               1
11    1   1111111   1111111  11   1     D   1    1               1
11    1   1     1   1     1  11   1     1   1    1               1
11    1  11     1   1     11 11   1     1   1    1               1
11    1  D   G  1   1  G   D 11   1     1   1    1               1
11    1  11     1   1     11 11   1     1   111111               1
11    1   1     1   1     1  11   1     1   1    1               1
11    1   1111111   1111111  111D11111111   1    1               1
11    1                      11             1 G  1               1
11    1                      11             D  111               1
11    1          111         11     111     111111               1
111111111111111111111111111111111111111111111111111111111111111111
