111111111111111111111111111111111111111111111111111111111111111111
1 11         D  111     1               D  G  1  G  1  G  1  G  11
1 1          1    1     1            1  1     1     1     1     11
1 1   11111111  G 1     1   G1       1  1     1     1     1     11
111D1111111111111111   111111111111111111     1     1     1     11
11           1               1         11     1     1     1     11
11           D               D         1111D11111D11111D11111D1111
11           1               1          1                       11
11    111111111111111D11111111111111    1                       11
111  11     11     1   1     11    1    D                       11
111  11      1G    D   D    G1     1    1                       11
111  11      1     1   1     1     1    1                       11
11    111111D111111111111111111D1111   1111D11111D11111D11111D1111
11      111   111   111                11     1     1     1     11
11                                     11     1     1     1     11
11                                     11     1     1     1     11
11      111   111                 111  11     1     1     1     11
11111111111111111111   111111   111111111  G  1  G  1  G  1  G  11
1                1111D11111111D11111111111111111111111111111111111
1             GG 1                      11111111111111111111111111
1             GG 1                      1                       11
1                1                      1                       11
1   111111111111111111111111111111111   1                       11
1   1       111111111       11     11   1   11111111111111111   11
1   1       1       1       1       1   1   1       1       1   11
1   1       1       1       1       1   1   1       1       1   11
1   1       D   G   D       D   G   1   1   1   G   1   G   1   11
1   1       1       1       1       1   1   1       1       1   11
1   1       1       1       1       1   1   1       1       1   11
1   1       111111111       11     11   1   111111D111D111111   11
1   1111D1111111111111111111111111111   1                       11
1   11     11                11111111   1                       11
1   1       1                1      1   1                       11
1   1       1                1      1   1111111111111111111111D111
1   1   G   1                1      D   1                   1   11
1   1       1                1      1   1                   1   11
1   1       1                1      1   1                   1   11
1   11     11                1      1   1   11111   11111   1   11
1   1111D11111111111111111111111D1111   1   1       1   1   1   11
1   11      1       1       1       1   1   1       1 G 1   1   11
1   1       1       1       1       1   1   1       1   1   1   11
1   11      1       1       1       1   11D111111   11D11   1   11
1   1       D      11       1       D   1   11111           1   11
1   11      1       1       1       1   1   1111            1   11
1   1       1       1       1       1   1   11111           1   11
1   11 1 1 11       1       1       1   1      11111111111111   11
1   111111111111D11111111111111111111   1   1               1   11
1   1       11      1     111       1   1   1               1   11
1   1       1       1     111       1   1   1               1   11
1   1       1       1       1       1   11D11111111111111   1   11
1   1       D       D       D       D   1               1   1   11
1   1       1       1       1       1   1               1   1   11
1   11      1       111   111       1   1               1   1   11
1   1 1     1      1  1   1 1       1   111111D111111   1   1   11
1   1  1D1111111111111111111111111111   1           1   1   1   11
1   1111 1111               1       1   1           1   1   1   11
1   1       1               1       1   1  1     1  1   1   1   11
1   1       1               1       1   1           1   1   1   11
1   1111111D1               1       D   D     G     D   1   1   11
1   1 11    1               1       1   1           1   11111   11
1   D 11    1               1       11D11  1     1  1   1       11
1  11D11D1111               1       1 G 1           1   D       11
1  1        1               1111111111 11           1   1       11
1111111111111111111111111111111111111111111111111111111111 1111111
