1111111111111111111111111111111111
1000010100000000101001001000010101
1010010000101010001000001000010101
1P00000001001000000000000000000011
1000010100000000101001001000010101
1010010000101010001000001000010101
1000000001001000000000000000000011
1000010100000000101001001000010101
1010010000101010001000001000010101
1000000001001000000000000000000011
1111111111111111111111111111111111
