11111111
10010001
10000001
10100001
10001001
10000001
11111111
